OBBPHHMMT
OBBPTHMTM
OOPHTHTMM
OOHHTHTMM
HOHHTHTMM
HDHHTMTMM
PDHHTMTMM
PDMMTMTMM
PDMMTMMMM
