DFFPPPHHHHHMMMMMT
FFFPPPHHHHHMMMMMM
FFPPPPHHHHHMMMMMM
PPPPPHHHHHHMMMMMM
PPPPPHHHHHMMMMMMM
PPPPHHHHHHMMMMMMM
HHHHHHHHHHMMMMMMM
HHHHHHHHHHMMMMMMM
HHHHHHHHHHMMMMMMM
HHHHHHHHHHMMMMMMM
HHHHHHHHHMMMMMMMM
HHHHHHHHMMMMMMMMM
MHHHHHMMMMMMMMMMM
MMHMMMMMMMMMMMMMM
MMMMMMMMMMMMMMMMM
MMMMMMMMMMMMMMMMM
MMMMMMMMMMMMMMMMM
